00111100
01111110
01100110
01101110
01100110
11111111
00011000
00011000
