00011000
00111100
00011000
00011000
01111110
10000001
10000001
01111110
