10000100
01100110
00000000
01111110
10000001
10000001
00111100
00000000
