11111111
10000001
10100101
10000001
10111101
10000001
11111111
00000000
