00011100
00111110
11100111
11111111
01111110
01111110
00011000
00000000
