01100110
01100110
00011000
00111100
01100110
11000011
10111101
01100110
