01100000
11110000
11111100
00011110
00001111
00000111
11111111
01111110
