11111111
11000011
10100001
10111101
10111101
10100001
11000011
11111111
