01100110
10011001
10011001
01100110
00000000
00110000
01111000
00110000
