01100110
10011001
10011001
01100110
00000000
00111100
00100100
00111100
