00111100
01111110
11000011
11111111
11111111
11111111
00111100
00111100
