00100010
01010100
11111111
11111111
01010100
00100010
00000000
00000000
