00111100
01000010
01000010
01000010
01111110
00000000
00011000
00011000
