00111100
01000010
11100111
11111111
01111110
00111100
00111100
00011000
