00100100
11111111
00100100
11111111
00100100
11111111
00100100
00011000
