01100110
01000010
01111110
01000010
01111110
01000010
01111110
00000000
