00111100
01111110
11100111
10111101
11111111
00100100
01111110
00110011
