00111100
01000010
01000010
01111110
00011000
00100100
01000010
10000001
