00011000
00111100
01100110
11111111
01100110
00111100
00111100
00111100
