01100110
01100110
00000000
01000010
00100000
00010000
00111100
00000000
