11111111
10000001
10100101
10000001
00000000
01000010
00111100
00000000
