00111100
01111110
11111111
11111111
11111111
01111111
00111100
00011000
