00011000
01100110
01100110
01111110
01111110
01100110
01100110
00011000
