00111100
01100110
01100110
01111110
00111100
00011000
00011000
00011000
