01100110
01100110
11111111
00000000
11111111
01100110
01100110
11111111
