00111100
01111110
11000111
11000111
01111110
00111100
00011000
00011000
