01100110
11001100
01111000
00111100
00011110
00001111
00000011
00000001
