00011000
00011000
11111111
01000010
01000010
01000010
11111111
00000000
