00011000
00111100
00011000
00011000
11111111
00011000
00011000
00011000
