00111100
01100110
11111111
11000011
11111111
11000011
01100110
00111100
