00011000
00011000
00011000
00011000
00111100
01100110
11100111
00000000
