00111100
01000010
01000010
11111111
11111111
10000001
10000001
11111111
