00111100
01000010
10000001
10000001
01000010
00111100
00000000
00000000
