11111111
11000011
10100101
01111110
00111100
01011010
10000001
11111111
