00011000
01100110
01100110
00000000
01100110
01100110
00011000
00000000
