00100100
01101110
11111111
10110101
11111111
10110101
11111111
00011000
