01000100
11001100
11111111
00110011
00110011
01010101
00011000
00000000
