00111100
01111110
11100111
11100111
11111111
00011000
00011000
00011000
