11111111
10000001
10011101
10011101
10000001
01000010
00111100
00000000
