00011100
00111110
01111111
11111111
11111111
01010101
01010101
00011000
