11000011
11000011
00000000
10000001
00010000
00111100
01000010
00000000
