00111100
01100110
01000010
01000010
01100110
01000010
01000010
00111100
