00100000
01100000
11110000
01100000
00110000
00011000
00001100
00000110
