01000100
01111110
11011011
11111111
00011000
00111100
01100110
11111111
