11111111
10000001
10111101
10111101
10111101
10111101
10111101
11111111
