00001100
00011110
00010100
00010100
00111110
01111111
11111111
00000000
