00111100
01100110
11000011
10000001
11000011
01100110
00111100
00000000
