01100110
01100110
00111100
11111111
11111111
00111100
00100100
01100110
