00011000
00111100
01111110
11011011
11111111
01100110
01000010
00000000
