00110000
01111000
11111100
11111100
00110000
00110000
01111000
00000000
