00011000
00111100
01111110
11111111
11111111
10000001
10000001
00000000
