01100110
00011000
00011000
11111111
00100100
01000010
01000010
00100100
