00111100
01111110
11011011
11011011
11111111
00011000
00011000
00011000
