00100100
01101100
11111110
11111111
11111111
01100110
01100110
01100110
