11111111
10000001
10100101
11000011
10110101
10111101
10000001
11111111
