00111100
01000010
11011011
11111111
11011011
01000010
00111100
00000000
