10000100
11000110
10111101
10111101
10000001
11000011
10100101
01011010
