00111100
01100110
01000001
01000001
01000001
01100110
00111100
00000000
