01000100
01111110
11111111
01111110
00011000
00011000
00111100
01000100
