11100111
10011001
01111110
11111111
11111111
01111110
10011001
11100111
