00011000
00011100
00111000
01110000
11100000
00110000
00011000
00001100
