10000001
01000010
00111100
11111111
00111100
01000010
10000001
00000000
