00111000
01111100
11111111
11111111
00110100
00111100
00000000
00000000
