00111100
01111110
11000011
11000011
01111110
00111100
00011000
00011000
