00100100
00100100
11111111
10100101
10100101
11111111
00011000
00011000
