01100110
01100110
00000000
01111110
10111101
10000001
01111110
00000000
