01100110
10011001
11111111
11111111
00011000
00111100
00000000
00000000
