11111111
10000001
10000001
11111111
00111000
01111100
11000011
11111111
