10000001
01000010
00111100
01100110
01100110
01000010
01111110
00111100
