00111100
01111110
11000011
11111111
01100110
00011000
00011000
00000000
