00000100
00000100
00111110
01111111
01111111
01111111
00011000
00011000
