01100110
10011001
10000001
01111110
01111110
10000001
10011001
01100110
