10000100
10100101
10011001
01111110
00100100
00110110
00111100
00000000
