00100100
01111110
11011011
11011011
01111110
00100100
00000000
00000000
