00000000
01111110
11000011
11011011
11011011
11000011
01111110
00000000
