11111000
11001100
11101000
11111000
01111110
00011000
00011000
00000000
