10000100
10100101
10000100
00000000
01111110
00111100
00111100
00000000
