00100100
01100110
11111111
10111101
11111111
01000010
00111100
00000000
