00011000
00111100
11111111
11111111
00100100
00011000
00011000
00000000
