11000011
10111101
10000001
11000011
11111111
01111110
00111100
00011000
