00011000
00111100
01111110
11111111
00111100
01100110
11000011
11111111
