00111100
01000010
01000110
01111111
01111111
00011000
00011000
00000000
