01100110
01100110
00000000
10001001
10100010
01000010
00111100
00000000
