01100110
00111000
11111111
11000011
11000011
11111111
00111100
00000000
