01111100
11000011
11111111
11000011
11111111
11000011
11111111
00000000
