00011000
00111100
01111110
11000111
11101111
10111011
00111000
00011000
