00111100
01100110
11011011
11000011
11111111
00011000
00011000
00011000
