00001000
00011000
00011100
11111111
00011100
00011000
00001000
00000100
