00111100
01100110
10100101
10000001
10100101
10011001
01111110
00000000
