00111100
01100110
11000011
11111111
11000011
11111111
11111111
00000000
