01100110
01100110
00000000
11111111
11100111
11111111
10000001
00011000
