01100110
00111100
00011000
00011000
01111110
00011000
00011000
00011000
