11111111
11000011
10100101
10011001
01111110
00111100
00011000
00000000
