11111111
10100101
10100101
11111111
10000001
01111110
01000010
00111100
