11000011
11000011
00000000
00010000
00100000
00010000
00001100
00000000
