11111111
10000001
11000011
10100101
10011001
10000001 
11000011
11111111
