11111111
10100101
10111101
11111111
10100101
10110101
11100111
00000000
