10101010
01111100
00111000
00010000
00010000
00011000
00111100
01111110
