01100110
01100110
00000000
00111100
11111111
10100001
10100001
00000000
