00111000
01111100
11100110
11000011
11000011
11100110
01111100
00111000
