11111111
11000011
10111101
11111111
11111111
10111101
11000011
11111111
