00111100
01000010
01000010
01000010
11111111
11111111
00000000
00000000
