01100110
01100110
00000000
00001000
00010000
00100000
00011110
00000000
