00100100
01111110
11011101
11011101
00100100
00110100
01010100
00100100
