00100000
01100000
11110000
01110000
00110000
00010000
00001000
00000100
