01100110
01100110
00000000
11111111
11111111
00011000
00011000
00011000
