00011000
01100110
01100110
11111111
11111111
01100110
01100110
00011000
