00011000
00111100
01111110
11111111
11111111
01100110
00000000
00011000
