00010000
01111000
10111110
00011111
01111110
00111000
00010000
00000000
