00111100
01000010
01000010
01111110
00100100
00100100
00100100
00000000
