00111100
01111110
11111111
10000001
11000011
11100111
10111101
10000001
