11111111
00100100
00100100
00100100
11111111
01000100
00011000
00011000
