01100110
01100110
00000000
01000010
00010000
00111100
00000000
00000000
