00011000
00111100
00011000
01111110
00100100
01000010
01000010
00000000
