00100100
01111110
11000011
11111111
11111111
10100101
10100101
11111111
