00011000
00011000
00011100
00011100
00011100
00111110
01111111
01111111
