00111100
01100110
01100110
01100110
01111110
01111110
01111110
00000000
