00100100
01101100
11111110
11111110
00100100
00100100
00100100
11111110
