00111100
01000010
01000010
00000000
00001000
00000100
00011000
00000000
