11111111
11100111
10100101
01111110
00111100
00011000
00011000
00000000
