00011000
00111100
01100110
11111111
11100111
11100111
00000000
00000000
