00100100
01100110
11111111
11111111
01100110
00011000
00000000
00000000
