10000001
11111111
01111110
00111100
00011000
00001000
00000100
00000010
