00011000
01100110
00111100
01100110
00011000
00111000
01000100
01111110
