00111100
01000010
11111111
11111111
01000010
00011000
00011000
00000000
