01010100
01111110
11111111
01111110
01010100
00000000
00100100
00011000
