11100011
01100110
00111100
00011000
00011000
01100110
11111111
11111111
