11100111
10011001
01111110
01111110
01111110
10011001
11100111
00000000
