00111100
01100110
11100111
11111111
11111111
11111111
01111110
00111100
