01111110
01000010
01000010
01111110
00000000
00011000
00100100
01111110
