00111100
01100110
01100110
01100110
01100110
01100110
11111111
11111111
