10000010
01001000
00110000
00011000
00001100
00000010
00001000
10000001
