00111100
01100110
11111111
10000001
10111101
10000001
10011001
01111110
