00011000
00111100
01111110
01111110
00111100
00011000
00011000
00011000
