00100100
01100110
00100100
01111110
01000010
00111100
01111110
00000000
