00110000
01111000
10110100
00110000
00110000
01111000
11111110
00011000
