00011000
00100100
00111100
01111110
01111110
11111111
01111110
00000000
