00011100
00011100
00000000
00111100
01100110
00011000
00100100
01000010
