00100100
01111110
11111111
01111110
00011000
00011000
00000110
00000000
