11111111
11000011
10100001
10000001
10000001
10100001
11000011
11111111
