00011000
00011000
00011000
01111110
01111110
11111111
11111111
00000000
