00111100
01000010
11111111
11111111
11111111
01011010
00100100
00000000
