11111111
01111110
00111100
01100110
10000001
10000001
01000010
00111100
