01100110
10011001
11111111
11111111
11111111
11101111
10000001
11111111
