01100110
01100110
00000000
00010000
10000001
01000010
00111100
00000000
