01111110
11111111
10111101
11111111
01010101
00011000
00000000
00000000
