K G G G K G G G
K K G G G G G G
K G K K G G G G
K G K K G G G G
K K G G G G G G
K G G G G G G G
K G G G G G G G
K G G G G G G G