K K G G G K K K
K K G G G K K K
K K G G G K K K
K K G G G K K K
K K K K K K K K
K K K K K K K K
G K K K K K K G
G G G G G G G G