K K G G G G K K
K G G K G G K K
K G G K G G K K
K G G K G G K K
K K G G G G K K
K G G K G G K K
K G G K G G K K
G G G G G G G G