K G G G G G G G
G K G G G G G G
G G G G G G G G
G G G G G G G G
G G G K K K G G
G G G K K K G G
G G G G G G G G
G G G G G G G G