K G G G G G G G
G K G G G G G G
G G K G G G G G
G G K G G G G G
G G G K G G G G
G G G K G G G G
G G G G K G G G
G G G G G G G G