   @@@         @@@
 @@@@@@     @@@@@@
@@@@@@@@@ @@@@@@@@@
@@@@@@@@@@@@@@@@@@@
 @@@@@@@@@@@@@@@@@
   @@@@@@@@@@@@@
     @@@@@@@@@@
       @@@@@@
         @@@
           @