```
    *        *     
       *     *        
 *           *   
       .               
  *   .     *      *
   *           *    
      .     *      
 *         .    *   
       *       *   

```