Here is an example ascii art of a window:

    ___________________
   /| ________________ |\
  / | |              | | \
 /  | |    WINDOW    | |  \
/___| |______________| |___\
|   |________________|   |
|   |                |   |
|   |                |   |
|   |                |   |
|   |                |   |
|   |                |   |
|   |                |   |
|___|________________|___|
