  ____  ____  
 / ___\/  _ \ 
 \___ \| / \ |
  ___) | \_/ |
 /____/\____/ 
