     @@@              @@@
   @@@@@@@        @@@@@@@
 @@@@@@@@@@    @@@@@@@@@@
@@@@@@@@@@@@  @@@@@@@@@@@
@@@@@@@@@@@@@@@@@@@@@@@@@
 @@@@@@@@@@@@@@@@@@@@@@@
   @@@@@@@@@@@@@@@@@@@@
     @@@@@@@@@@@@@@@@
       @@@@@@@@@@@@@@
         @@@@@@@@@@@
           @@@@@@@
             @@@
               @

