Here is an example of an ascii art of a lightning flash:

     ⠀⠀⠀⢀⣀⣀⡀⠀⠀⠀⠀⠀⠀⠀⠀⠀⠀⠀
⠀⠀⠀⠀⠠⣿⡿⠛⢻⡄⠀⠀⠀⠀⠀⠀⠀⠀⠀
⠀⠀⠀⠀⠀⣿⠁⠀⠈⣿⠀⠀⠀⠀⠀⠀⠀⠀⠀
⠀⠀⠀⠀⠀⣿⠀⠀⠀⣿⠀⠀⠀⠀⠀⠀⠀⠀⠀
⠀⠀⠀⠀⢠⣿⡆⠀⠀⣿⡆⠀⠀⠀⠀⠀⠀⠀⠀
⠀⠀⠀⠠⣾⣿⡇⠀⠈⣿⡇⠀⠀⠀⠀⠀⠀⠀⠀
⠀⠀⠀⠀⠈⢿⣿⡄⠀⣿⠇⠀⠀⠀⠀⠀⠀⠀⠀
⠀⠀⠀⠀⠀⠈⠻⣿⣿⠟⠀⠀⠀⠀⠀⠀⠀⠀⠀
⠀⠀⠀⠀⠀⠀⠀⠀⠉⠀⠀⠀⠀⠀⠀⠀⠀⠀⠀