⠀⠀⠀⠀⢀⡴⠚⠉⠉⠉⠙⠛⠛⠛⠻⣿⣷⣦⣤⣤⣤⣶⣶⣤⣤⡀⠀⠀⠀⠀⠀
⠀⠀⠀⣠⢶⣾⣿⣿⣿⣿⣷⣶⣤⣄⡀⠀⠀⠈⠉⠉⠉⠉⠉⠏⠙⢿⣿⣿⣿⣿⣦⡀⠀⠀
⠀⠀⢰⠋⣠⣿⣿⣿⣿⣿⡿⠿⠿⣿⣿⣿⣦⠀⠀⠀⠀⠀⠀⠀⠀⠀⠀⠈⠻⣿⣿⣿⡀⠀
⢀⠎⣸⣿⣿⣿⠟⠁⠀⢀⣤⡀⠀⠈⠻⣿⣿⣿⣆⠀⠀⠀⠀⠀⠀⠀⠀⠀⠈⢻⣿⣿⡇⠀
⢣⠏⠸⣿⣿⣿⡆⠀⢠⡿⠁⠀⠀⠀⠈⠻⣿⣿⣿⡇⠀⠀⠀⠀⠀⠀⠀⠀⠀⠘⣿⣿⡇⠀
⠈⠳⣄⠙⠿⣿⣿⣴⣿⡇⠀⠀⠀⠀⠀⠀⠈⠻⣿⣿⡇⠀⠀⠀⠀⠀⠀⠀⠀⠀⢸⣿⡇⠀
⠀⠀⠈⠉⠉⠉⠉⠉⠁⠀⠀⠀⠀⠀⠀⠀⠀⠀⠈⠉⠁⠀⠀⠀⠀⠀⠀⠀⠀⣠⣾⣿⠃⠀
⠀⠀⠀⠀⠀⠀⠀⠀⠀⠀⠀⠀⠀⠀⠀⠀⠀⠀⠀⠀⠀⠀⠀⠀⠀⠀⠀⠀⢀⣾⣿⡟⠀⠀
⠀⠀⠀⠀⠀⠀⠀⠀⠀⠀⠀⠀⠀⠀⠀⠀⠀⠀⠀⠀⠀⠀⠀⠀⠀⠀⠀⢀⣾⣿⠟⠀⠀⠀
⠀⠀⠀⠀⠀⠀⠀⠀⠀⠀⠀⠀⠀⠀⠀⠀⠀⠀⠀⠀⠀⠀⠀⠀⠀⠀⠀⠀⠸⠟⠀⠀⠀⠀