GGGGKGKG
GGGGKGKG
GGGGGGKG
GGGGKKKG
GGGGKKKG
GGGGGGKG
GGGGGGKG
GGGGGGKG