KGGGGGGG
GGKKGGGG
GGGKKGGG
GGGGKGGG
GGGGGKGG
GGGGGGKG
GGGGGGGK
GGGGGGGG