KGGGGGGG
KGKKKKGK
KGKKKKGK
KGKKKKGK
KKGKKGK
KGGGGGKG
KGGGKGKG
KKGGGKKG