GGKKKKGG
GKKKKKKG
KKGGGGKK
KKGGGGKK
KKGGGGKK
KKGGGGKK
GKKKKKKG
GGKKKKGG
