KKKGGGKK
KKKGGGGG
KKGGGGGG
KGGGGGGK
GGGGGGGG
GGGGGGGG
GGGKKGGG
GGKKKGGG