KKKKKKKK
KGKKKKKG
KKKKKKKK
KKKGGKKK
KKGGGKKK
KGGGKKKK
KGGKKKKK
KKKKKKKK