KKKKKKKK
KGGGGGGK
KGKKKKGK
KGGGGGGK
KGGKKGGK
KGGKKGGK
KGGKKGGK
GGGGGGGG