GGGGGGGG
GKKKKKKG
GKKKKKKG
GKKKKKKG
GGGGGGGG
KKGGGGKK
KKGGGGKK
KKGGGGKK
