KKKKKKKK
KKGGGGKK
KKGKGKKK
KGGKKGGK
KKGKKGKK
KKGKKGKK
KGKGKGKK
KKGGGGKK