GGGGGGGG
GGGGGGGG
KKKGKKKK
KKKGGKKK
KKGKKGKK
KGGKGGKK
KKGKKGKK
GGGKKGGG
