KGGKKGGG
GGGGGGGG
GGGGGGGG
GGGGGGGG
GGGGGGGG
KGGKKGGG
GKKKKKGG
GGGGGGGG