GKKGGGGG
GGGKGGKG
GGGGGGGG
GKGGGGKG
KGGGGGGK
GGGGGGGG
GGGKGGGG
GKGGGGKG