KKGKKGKK
KKGKKGKK
GGGGGGGG
GGGKGGGG
KGKKGGGK
GKGGGGKG
GGKKKKGG
GGGGGGGG