GGGGGGGG
KKGGGGGG
KKGGGGGG
KKGGGGGG
KGKKGKGK
KGKKGKGK
GGGGGGGG
GGGGGGGG