KGGGGGGK
KKKGGGKK
KKKGKKKK
KKKGGGKK
GGKKKKGK
GGKKKKKK
GGGGGGKK
GGGGGKKK