GGGGGGGG
GKGGGGKG
GGGGGGGG
GKGGGGKG
GGGKGGGG
GGGKGGGG
GGGGGGGG
GGGGGGGG
