KGGGGGGG
GKKGGKGK
GKGGGGKG
KKKGGGKK
KKGKKGKK
GKGGGGKG
GKKGGKGK
KKGGGGKK
