GGGGGGGG
GGGGGGGG
GGGKGKGG
GGGKGKGG
GGGGGGGG
GGKGGKGG
GGGKGGGG
GGGGGGGG