KKKKKKKK
KKKKKGKK
KGGKGKKK
KKKKGKKK
KKKKGKKK
KKKKKKKK
KKKKKKKG
KKKKKKKG