KKKGGKKK
KKKGGKKK
KKGGGKKK
KGKGKGKK
GKGKGKGK
KGKGKGKG
KKGKGKKK
KKGKGKKK