GKKGGKGK
GKKGGKGK
GGGGGGGG
KGGGGGGK
KKGGGKKK
KGGGGGGK
KGKKKGGK
GGGGGGGG