GGKKKKGG
GKKKKKKG
KKGKKKKG
GGGGGGKG
GGGGGGKG
GGGGGGGG
GGGGGGGG
GGGGGGGG
