GKKKKKKG
GGKKKKGG
GGGKKGKG
GGGGKGGG
GGGGKGGG
GGGGGGGG
GGGGGGGG
