GKKKGKKG
GKKKGKKG
GKKKGKKG
GGGGGGGG
KGKKGKKK
GKKKGKKG
GGGGGGGG
GGGGGGGG