KGGGKKGK
KGKKKKGK
GKKGGKKG
GGGGGGGG
GGKKKGGG
GGKKKGGG
GGGGGGGG
GGGKKGGG