KKKKKKKK
KGGGGGGK
GGKKKKGG
GKGGGGKG
KGGKKGKK
GKGKGKGK
KKKKGKKK
KGGGGGGK