GKKGGKKG
GKGGKGGK
GGGGGGGG
GGGGGGGG
GKKGGKKG
GKKGGKKG
GGGGGGGG
GGGGGGGG