KKKGGKKK
KKGGGGKK
KGGGGGGG
GGGKGGGG
GGGGGGGG
KGGGGGGG
KKGGGGKK
KKKGGKKK
