GKKGGKKG
GKKGGKKG
GGGGGGGG
GGGGGGGG
KGGGGGGK
GKKGKKGK
GKGKGKGK
GGGGGGGG