GGGGKKKK
GGGKGGKK
GGGGKKKK
GGGGGKKK
GKKGGGGK
GKGGGGKK
GKGKGKGK
GGGKGGKK