KKKKGGGG
KKKKGGGG
GGGGGGGG
GGGGKGGG
GGGGKGGG
KGGGGGGK
KGGKGKKG
KGKGKGKG