KKKKKGGK
KKKKKGGK
KKKKKGGK
KKGGGKKG
KKGGGKKG
KKGGGKKG
GGKKKGGG
GGGGGGGG