GGGGGGGG
KKGGKKKK
KGGGKGKG
GKKGKGKG
KGGKKGKG
KKGGKGKG
KKKGKKKG
GGGGGGGG