GGKKKGKG
GGKKKGKG
GGKKGKGK
GGKKGKGK
GGKKKKGK
GGKKKKGK
GGGGGGGG
GGGGGGGG