GKKKGKKG
KKKGKKGK
KKGGKKKG
KKKGGKKG
GGGGGGGG
GGGGGGGG
GGGGGGGG
GGGGGGGG