GGGGGGGG
GKKKKGKG
GGGGGGGG
GGGKKGKG
GGKKKKKG
GKGKGKGK
GKGKGKGK
KGKGKGKG