GKKKKKKG
GGKKKKGG
GGGKKGGG
GGGGGGGG
GKKKKKKG
GGGGGGGG
GGGKKGGG
GGGGGGGG