KGGGGGGK
KGGGGGGK
KKGGGGKK
KKGGGGKK
KKGGGGKK
GGGKKKGG
GGGGGGGG
GGGGGGGG