GGGGGGGG
GKKGKGKG
KGGGGGGG
GGKGGGGG
GGGGKGKK
GGKKGGGG
KGKKGGGG
GGGGGGGG