KKKGGKKK
KGGKGKKG
GGGGGGGG
GKGKGKGK
GGGGGGGG
KGGKGKKG
KKKGGKKK
GGGGGGGG