KKKKKKKK
KKKKKKKG
KKKKKKGG
KKKKKGGG
KKKKGGGG
KKKGGGGG
KGGGGGGG
GGGGGGGG