KKKKKKKK
KKKKKKKK
KGGKKGKK
GGGGGGGG
GGGGGGGG
KGGGGGGK
GKGGGGKG
GGKKKKGG