GGGGGGGG
GGKKKGGG
GKGGGGKG
GKKGKKKG
GKKGGKKG
GKKKKKKG
GGGGGGGG
GGGGGGGG