KGGGKGGG
GGGGGGGG
GKGKGKGK
GKGKGKGK
GGGGGGGG
GGGGGGGG
GGGGGGGG
GGGGGGGG