KKGGGGKK
KGGGGGGG
GGGGGGGG
GGKKKKGG
KGKKKKGK
KGKKKKGK
GGKKKKGG
GGGKKGGG