GGGGGGGG
GGKKKGGG
GKGGGKGK
GGGGGGGG
GGGKGGGG
KGGGGGGG
GGGGGGGG
GGGKGGGG
