KKKKKGGG
KKKGGGGG
KKGGGGGG
KKGGGGGG
KKGGGGGG
KKKGGGGG
KKGGGGGG
GGGGGGGG