GGKKKKGG
GKKKKKKG
KKKKKKKK
GGGGKGGG
GGGGKGGG
GGGGKGGG
GGGGKGGG
GGGGKGGG
