GKKKGGGG
GKKKGKKG
GGGKGGGG
GKGGGGGG
GGGGGGGG
GGGGGGGG
GGGGGGGG
GGGGGGGG