KGGGGGKK
GKGGGKGK
GGGGGGGG
GGKGGKGG
GGKGGKGG
GGGGGGGG
GGKGGKGG
GKGKGKGK