KGGGKGGG
KKGKKGGG
GGGKGGGG
GKGKGKKG
GKKKGKKG
GKKKGKKG
GKGKGKGK
GKGKGKGK