KKGGGGKK
GKKKKGKG
KGKKKGKG
KKGKKGKG
KKKGKGKG
KKKGKGKG
KKKGKGKG
GGGGGGGG