GGGGGGGG
GGGGGGGG
GGGGGGGG
GGGGGGGG
GGKKKGGG
GKKKKGKG
GGGGKGKK
GGGGGGGG