GGGGGGGG
GGGGGGGG
GGKKKKGG
GGKKKKGG
GGKKKKGG
GGGGGGGG
GKGGGGKG
GGGGGGGG