GGGGGGGG
GGGKKGGG
GGKKKKGG
GKKKKKKG
KKKKKKKK
KKKKKKKK
GKKKKKKG
GGKKKKGG
