KKKKKKKK
KKKGGGKK
KKKGGGKK
KKKGGGKK
KKKGGGKK
KKKKKKKK
KGGGGGGK
GGGGGGGG