KKGGGGKK
KKGGGGKK
KKKKKKKK
GGKKKGGG
GGKGGKGG
GGGKKGGG
GGGGKGGG
GGGGGGGG