GGGGGGGG
GGKKKKGG
GGKKKKGG
GGKKKKGG
GKGGGGKG
GKGGGGKG
GKGGGGKG
GGKGGKGG