KKKKKKKK
KKKKKKKK
GGGKGGGG
GKKKGKKG
GKKKGKKG
GGGKGGGG
GKKKGKKG
GGGGGGGG