KKKKKKKK
KKGGGGKK
KKGGGGKK
KKGGGGKK
KKGKKGKK
KKGGGGKK
KKKKKKKK
KKKKKKKK