GKKGGGKK
KGGGKKGG
GGGGKGKG
KGGGGKGG
GKKGGGGK
GGKKGGKG
KGGGKGGG
GKGKGKGK