KGGKGGKK
KKKKGKKK
KKKKKKKK
KKKKGKKK
GKKGKKKG
GKKGGKKG
GGGKGGGG
GGGKGGGG