GGGGGGGG
GGGKGGGG
GKKKGGGG
GKKKGGGG
GKKKGGGG
GGGGGGGG
GGKGGKGG
GGGKKGGG