KKGGGGKK
KGGGGGGG
KGKKKKKG
KGGGGGGK
GKKGKKKG
GGGGGGGG
GGGGGGGG
GGGGGGGG