KGGGKGGK
KGGGKGGK
KKGGGGKK
KKGGGGKK
GGGGGGGG
GGGKKGKG
GGGKKGKG
GGGGGGGG