KGGGKGGG
GGGGGGGG
GGGGGGGG
GGGGGGGG
KGGGGGGK
GGGKGGGG
GGGGGGGG
GGGGGGGG