KKKGGKKK
KKGKKGKK
KKKKKKKK
GKGKGKGK
KKKKKKKK
GKGKGKGK
KKKKKKKK
GKGKGKGK