GGGKGGGG
GGKGGKGG
GKGGGKGK
GGGGGGGG
KGKGKGKG
GKKGKKGK
KGGGGGGK
GGGKKGGG