GKKGGKKG
GKKGGKKG
GGGGGGGG
GKGGGGKG
GGGGGGGG
GGKGGKGG
GGKGGKGG
GGGGGGGG