GKKGGKKG
GKKGGKKG
GGGGGGGG
GGGKGGGG
KGGGGGGK
GKGGGGKG
GGKKKKGG
GGGGGGGG