GKGGGGKG
GKKGGGKG
GKGGGGKG
GKKGGGKG
GKKGGGKG
GKGGGGKG
GGGGGGGG
GGGGGGGG