KKKKKKKK
KKKGGKKK
KKKGGKKK
KKKKKKKK
KGGGGGGK
GKKGGKKG
GGKGKKKG
GGGGGGGG