KKKKKKKK
KKKKKKKK
KGKKKKGK
KGGGGGKG
GGGKKGGG
GGGGGGGG
GGGGGGGG
GGGGGGGG