GKGKGKGK
GGKGKGKG
GGGKGKKG
GGGGKGKG
GGGGGKGK
GGGGGGKG
GGGGGKGK
GGGGKGKG