KKGKKKKK
KGGKKKKK
KKKKKKKG
KKKKKKKG
KKKKKGGG
KKKKKGGG
KKKKKGGG
KKKKKGGG