GGGGGGGG
GGGKKGKG
GGKGKGGK
GGKGKGGK
GGGGGGGG
GGKGGGGG
GGKGGGGG
GGKGGGGG
