GGKKKKGG
GGKGGKKG
GGGKKGGG
GGGKKGGG
GGGKKGGG
KKGGGGKK
KKGGGGKK
KKGGGGKK