GKKKKGGG
GKKKGGGG
KGKKKGGG
GKKKGGGG
GKKKKGGG
GKKKGGGG
GKGGKGGG
GGGGKGGG