GGGGGGGG
KKGGKGGK
KGGGGGGK
GKKGGKKG
GKKGGKKG
KGGGGGGK
KKGGKGGK
GGGGGGGG