KGGGGGGK
GKKGGGKG
GGGGGGGG
GGGKKGGG
GGGKKGGG
GGGKKGGG
GGGKKGGG
GGGKKGGG
