GGGKKGGG
GKKKKKKG
GGKKKKGG
GKKGGKKG
GGGGGGGG
KGGGGGGK
KKGGGGKK
KKGGGGKK