KGGGKGGG
KKKKKGGG
KGKGKGKG
GKGKGKGK
GGKGKGGG
GGKGGKGG
GGGGGGGG
GGGGGGGG