GGGGGGGG
GKKKKKKG
GKGGGGKG
GKGGGGKG
GKKKKKKG
GKGGGGKG
GGGGGGGG
GGGGGGGG