GGGGGGGG
GKGGGKGK
GGGGGGGG
GGGGGGGG
GGGGGGGG
KKKPKKKK
GGGGGGGG
GGGGGGGG