GGGGGGGG
GGGKGGGG
GKGGGGKG
GGKKKKGG
KGGGGGGK
GGGGGGGG
GGGGGGGG
GGGGGGGG