KKKKKKKK
KKKKKKKK
KKKKKKKK
KKKGKKKK
KKKGKKKK
KKKGKKKK
KKGKGGKK
KKGKGGKK