KKKKKKKK
KGGGGGGK
KKKKKKKK
KGKKGKKG
KGKKGKKG
KKKGGKKK
KGGGGGGK
KKKKKKKK