KKKGGGKK
KKGGGGKK
KGGGGGGG
KGGKKGKG
GKKGKKKG
GGGKKGGG
GGGGGGGG
GGKKKKGG