KGGGGGGG
KKKKGGKK
KGGGGGGG
KGKKGKKG
KGKKGKKG
KKKKKKKK
KGGGGGGG
KKKKKKKK