GGKGGKGG
GKGGGGKG
GGGGGGGG
KGGGGGGK
GGGGGGGG
GKGGGGKG
GGGGGGGG
KGGGGGGK
