KKKKKKKK
KKGGKKKK
KKGGKKKK
KKGGKKKK
KKGGKKKK
KKKKKKKK
KKGGKKKK
KKKKKGGK