KKKKKKKK
KKKGGKKK
KKGGGGGK
KGGGGGGG
GGGGGGGG
GGGGGGGG
GGGGGGGG
GGGGGGGG