KKKKKKKK
KKKKKKKK
GGGKKGGG
KKGKKGKK
KGGGGGGK
GKGGGGKG
GGGKKGGG
KKKKKKKK