GGGKKGGG
GGGKKGGG
GGGKKGGG
GGGGGGGG
GKKKKKKG
GKKKKKKG
GKKKKKKG
GGGGGGGG