GKGKGKGK
KKKKGKKK
KKKKGKKK
KKKKGKKK
GKKKKKKG
GGKKKKGG
GGGKKGGG
GGGGGGGG
