GKKGGKKG
GKKGGKKG
GGGGGGGG
GKKKKGKG
GGKGGGGG
GGGGGGGG
GGGKGGGG
GGGGGGGG