GKKKKKKG
GKKKKKKG
GGGGGGGG
GKKKGKKG
GKGKGKGK
GKGKGKGK
GGGGGGGG
GGGGGGGG