KGKKGGGK
KKGKGKKK
GKGGGGKK
KKGGGGKK
GKKGGKKK
GKGKGKGK
GGGGGGGG
GGKGKGKG