GGGGGGGG
GGGGGGGG
GGGGGGGG
KKGGGGKK
KKGGGGKK
KGKGKGGK
KGKGKGGK
KGKGKGGK