KKKKGGKG
KKKKKGGG
KKKKKGGG
KKKKKGKG
KKKKGGGG
KKKKGGGG
GGGGGGGG
GGGGGGGG