GGGGGGGG
GKKKGGKG
GKGKGKGK
GKKKGKKG
GKKKGKKG
GKGKGKGG
GKKGGKKG
GGGGGGGG