GKGGGGKG
GKKKKGKG
GKKKKGKG
GGGKKKGK
KGKKKGKG
GGGGGGGG
GGGGGGGG
GGGGGGGG