GGGGGGGG
GKKKKKGG
GKKKKKGG
GKGKKKGK
GGKKKKGG
GGKKKKGG
GGKKKKGG
GGGGGGGG