GKKKGKKG
GGKKKKGK
GGGGGGGG
GKKGGKKG
GKGKGKGK
KGGGGGGK
GKKGGKKG
GGKGKGKG