GGGGGGGG
GKKGGKKG
GKGKGKGK
GGGGGGGG
GKKGGKKG
GKKGGKKG
GKGKGKGK
KGKGKGKG