KGGGGKGG
KKGGGGKK
KKGKKGKK
KGKKKKKG
GKKKKKKG
GKKKKKKG
KGKKKKKG
KKGKKGKK