GGGGGKGG
GGGGGKGG
GGGGGKGG
GGGGGKGG
GGGGGKGG
GGKKKKGG
GGGKKGGG
GGGGGGGG