KGGGKGGG
KKKKKGGK
GKKKGGKK
GKKKGKKK
GKKKGKKK
GGGGGGKK
GGGGGGKG
GGGGGGGG