GKGKGKGK
KGKGKGKG
GGGKGGGG
GGKGGKGG
GKKGKGGG
GKGGGGKG
GGGGGGGG
GGGGGGGG