GGGGGGGG
GKKKKKKG
GKKKKKKG
GGKKKKGG
GGKGGKGG
GGGKKGKG
GGGKKGKG
GGGGGGGG