GKKKGKKK
KKKKGKGG
KKKKKGKK
GKGGGGKG
GKGGGGKG
GKGGGGKG
GKKGGKKG
GGGGGGGG