GGGGGGGG
GKKKKKKG
GKKKKKKG
GGGGGGGG
GGGKKGGG
GGKKKGGG
GGGGGGGG
GGGGGGGG