GGGGGGGG
GGGKKGGG
GGGKKGGG
GGGGGGGG
GGGGGGKG
GGGGKGKK
GGGGKGKK
GGGGGGKK