KKKKKKKG
KKKKKKKG
KGGGKKGG
KGKKKGGK
KGKKGGKK
KKGKKKKK
KKKKKKGK
KGKKKKKG