GGGGGGGG
KKKGGKKK
KGGGGGGK
KKGKKGKK
KKGKKGKK
KGGGGGGK
KKGGGGKK
GGGGGGGG