GKGGGGGG
GGGGGGKK
GGGKGGKK
GGGKGGKK
GGGKKGGK
GGGKKGGK
GKGGGGKK
GGGGGGGG