KKKKKKKK
KKGGGGKK
KGGGGGKK
GGGGGGGK
GGGGGGGG
GGGGGGGG
KKGGGGGG
KGGGGGGG