GKGKGKGK
KGKKKKKG
KKGKKGKK
KKKKKKKK
KKKKKKKK
KKGGGGKK
KGGGGGKG
KGGGGGKG