GKKKKKKG
GKKKKKKG
GGGGGGGG
KKGGGGKK
KKGGGGKK
GKKGGKKG
GKGGKGKG
KGGKGGK
