GKGGGGKG
GKGGGGKG
GGGGGGGG
GGKKKKGG
GGKGGKGG
GGKGGKGG
GGKKKKGG
GGGGGGGG