GGGGGGGG
GKKKGGGG
GGGGGGGG
GGKKGGGG
GGKKGGGG
GKKKGGGG
GGGGGGGG
GGGGGGGG