GKKGGKKG
GKKGGKKG
GGGGGGGG
GKGGGGKG
GGKKKKGG
GGGGGGGG
GGGGGGGG
GGGGGGGG