GKGKGKGK
GGKGKGGG
GGGKGGGK
GGGKGKGK
GGGKGKGK
GGGKGKGK
GGKGKGGG
GKGKGKGK