KKKKKGGG
KKGGGGGG
KGGGGGGG
GGGGGGGG
GGGGGGGG
GGGGGGGG
KGGGGGGG
KKGGGGGG