GGGGGGGG
GGGGGGGG
GGGGGGGG
GGGGGGGG
GKKKKGKK
GKKKKKKG
GKKKKKKG
GGGGGGGG