KKKGGKKK
KKGGGGKK
GGGGGGGG
GGGGGGGG
KKGGGGKK
KKKGGKKK
GKKGGGKG
GGKGKGGG