GGGGGGGG
GGKKKGGG
GKKKKKGG
GGGGGGGG
GKKKKKGG
GGGGGGGG
GGGGGGGG
GGGGGGGG