GGGGGGGG
GGGKGGGG
GGGGGGGG
KGGGGKGG
KGKKKGKK
GGGGGGGG
GGGKGGGG
GGGKGGGG
