KKGGKKKK
KKKKGKKK
KGGGKKKK
KGGGKKKG
KKKKGKKK
KGGGGKKK
GGGKGGGG
GGGGGGGG