GGGKGGGG
GGKKKGGG
GGGKKGGG
KKKKKKKK
KKKKKKKK
GGGKKGGG
GGKKKGGG
GGGKGGGG