GGGGGGGG
GGGKKKGG
GKKKKKKG
GKKKKKKG
GGKKKGGG
GGGGGGGG
GGGGGGGG
GGGGGGGG