KKGGGGGG
KKKKGGGG
KGGGGGGG
KGGGGGGG
KKKGGGGK
GKGGGGKG
GGGGGGGG
GGGGGGGG