GGKKGGGG
GKKKGKKG
GGKKGGGG
GGKGGKGG
GGKKGGGG
GKKGKKKG
GKKGGKKG
GGGGGGGG