GGGGGGGG
GGGKKGGG
GKGGKGGK
GKGGKGGK
GKKKKKKK
GKKKKKKK
KKKGGKKK
GGGGGGGG