GKKGGKKG
GGKGGKGK
GGGGGGGG
KGKKKKGK
GKGKGKKG
GGKGGKKG
GKGKGKKG
GGGGGGGG