GGGGGGGG
GGKKKGGG
GGKKKGGG
GGKKKGGG
GGKKKGGG
GGGGGGGG
GKKGGKKG
KKKGGKKG