GKKKKGKG
GKKGKGKG
GKKKKGKG
GKKKKGKG
GKKKKGKG
GKKKKKKG
GKKGKKKG
GGGGGGGG