GKKKKGGG
KGGGGKKG
GGKKKKGG
GGGGGGGG
GKKGKGGG
GKKGKGGG
GKGGGGGG
GKGGGGGG