GGGGGGGG
GGGGGGGG
GGGGGGGG
GGKKKGGG
GGKGGKGG
GGGGGGGG
GGGGGGGG
GGGGGGGG