GKKKKKKG
GKKKKKKG
GGGKKGGG
GGGKKGGG
GGGGGGGG
GGGKKGGG
GGGKKGGG
GGGKGGGG