KGGGKGGG
GKKKKKKK
GKGGGGKG
GKGKKGKG
KGKKKKKG
GKGGGGKG
GKGGGGKG
KGGGKGGG