GGGGGGGG
GGGGGGGG
GGGGGGGG
GGKGGGGG
GGGGGGGG
GGKGKKKG
GGKGGGGG
GKKGKKKG