GKKKGGGG
GKKKGGGG
GGGGGGGG
KKKKKGGG
KGGGGGGG
KGGGKKGG
KKKKKKGG
KKKKKKGG