GGGGKGGG
GKKKGGKG
GKKKKKKK
KGGKKGGK
GKGGGKGK
GGGGGGGG
GGGGGGGG
GGGGGGGG