GGGGGGGG
GGGGGGGG
GKKGGGGG
GKKGGGGG
GKKKGGGG
GKKKGGGG
GKKKGGGG
GGGGGGGG