GKKGGKKG
GKKGGKKG
GGGKKGGG
GGGKGGGG
GGGGGGGG
GGGKGGGG
GKKKGGKG
GGGGGGGG