KKKGKKKK
KKKGKKKK
GGGGGGGG
GGKKKGGG
GKKGGGKG
GKKGKKKG
GGKKKGGG
GGGGGGGG