GGGGGGGG
GGGGGGGG
GGKKKKGG
GKKKKKKG
GKKKKKKG
GKKGGGKG
GGGGGGKG
GGGGGGGG