GKKKGGKK
GGKGGKKG
KKGGGGKK
KKGGKKKK
KKKKGKKK
KKKKKKKK
KKGGGGKK
GGGGGGGG