KKKKKKKK
KKKKKKKK
KKGGGGKK
KKGGGGKK
KKKKKKKK
KGGGGGGK
GKKKKKKG
GGGKKKGK