GKKKKKKG
GKKKKKKG
GGGGGGGG
KKGGGKKK
KKGGGKKK
KKGGGKKK
GGKKKGGG
GGGGGGGG