GGGGGGGG
GGGGGGGG
GGGGGGGG
GGGKKGGG
GGKGGKGG
GKGGGGKG
GGKKKKGG
GGGGGGGG