GGKKKKGG
GKKKKKKG
GGGGKGGG
GGGKGGGG
GGGGGGGG
GGGKGKGG
GGGGGGGG
GGGGGGGG