KGKKKGGK
KKKKKGKK
KKKKKGKK
GKKKKGKK
GKKKKKGK
KKKKGKKG
KKKKKKKK
KKKGKKGK