KKKKKKKK
KKKGGKKK
KKGGGKKK
KGGGGGKK
KGGGGGGK
KKGGGGKK
KKKGGKKK
KKKKKKKK