KKKKKKKK
KKKGGKKK
KKKGKKKK
KKKGGKKK
KKKKKKKK
GGGGGGGG
GGGGGGGG
GGGGGGGG