GGGGGGGG
GKKGGKKG
GKKGGKKG
GGGGGGGG
GGGGGGGG
GGKKKGGG
GGGGGGGG
GGGGGGGG