KKKKKKKK
KKKKKKKK
KKKKKKKK
KKGGGGKK
KGKKKKGK
KGGGGGKG
KGGKGGGK
GGGGGGGG