GKGGGKGG
GKGKGKGG
GGGGGGGG
GKGKGKGG
GKGKGKGG
GKGGGKGG
GKGKGKGG
GKGKGKGG