GGGGGGGG
GKKKGGGG
GKKKGGGG
GGKKGGGG
GGGGGGGG
GGGGGGKG
GKKKKGKG
GKKGKGKG