GGGGGGGG
GKKKKKGG
GKKGGKKG
GKKGGKKG
GKKGGKKG
GKKGGKKG
GKKKKKGG
GGGGGGGG
