GGGGGGGG
GKKKKKGG
GKKKKKGG
GKKKKKGG
GGKKKGGG
GGGGGGGG
GGGKGGGG
GGGKGGGG