GGGGGGGG
KKKGGGGG
KKKKKGKG
KKKKKKKK
KKKKGKKG
KKKKGKKG
GGGGGGKG
GGGGGGGG