GGGKGGGG
KKGGGKKG
KGGGKGGG
GKKKGGKG
GGGGGGGG
GKKKGGKG
KGGGKGGG
KKGGGKKG
