GKKGGKKG
GKGGGKKG
GGGGGGGG
GKKKGKKG
GGKGKGKG
KGKGKGKG
GKKGGKKG
GKGKGKGK
