GGGGGGGG
GGGGGGGG
GGGGGGGG
GGKKKGGG
GGKKKGGG
GGKKKGGG
GKKKKGKG
GKKKKGKG