GGGGGGGG
GGGGGGGG
GGGGGGGG
GGKKKGGG
GGKKKGGG
GGGGGGGG
GGKKGKGG
GGKKGKGG