GGGGGGGG
GGGGGGGG
GGGGGGGG
GGGGKGGG
GKGKKGKG
GKKGKKGK
KKKGKGGK
KGKKGKKG