GGGGGGGG
GGKKKGGG
GGKKKGGG
GGGGGGGG
GKKGKKGK
GKKGKKGK
GKKGGKKG
GGGGGGGG