KKKKKKKK
KKKKKGGG
KKKKKGGG
KKKKKGKG
KKKKKGKG
KKKKKGKG
KKKKKKKK
GGGGGGGG