GGGGGGGG
GGGGGGGG
GGGGGGGG
GGGGGGGG
KKGGKKKK
KKGKKKKG
GKKKKKKG
GGGGGGGG