00000100
00001100
00011100
00111000
01111100
11111110
01111100
00000000