11100111
11100111
00000000
10011001
10000001
01000010
00111000
00000000