01100110
01100110
00000000
00000000
11111111
00111100
00000000
00000000
