01111110
11111111
11111111
11111111
11111111
01111110
00100100
00011000
