01010101
00011000
01010101
11111111
11111111
11111111
01111110
00111100
