01100110
11100111
11000111
10011111
10011101
10011111
01100111
00000000