01111110
01000010
01000010
01000010
01111110
00010000
00001000
00000100
