00000000
01100110
01000010
01000010
01111110
01111110
00000000
00000000
