01010101
01101110
01101110
01100100
01101001
01101110
01100111
00100000