00011000
00111100
01111110
00111100
00100100
01100110
01000010
01000010