10011001
11001100
11111111
11111111
11111111
01111110
00111100
00111100
