01100110
01100110
01111110
01111110
11111111
11111111
01111110
00111100