00100010
01100011
11100111
11111111
11111111
01111110
00111100
00011000
