01111110
11111111
11111111
11111111
00111100
00001110
00000011
00000010
