11111111
00000111
00000001
00011110
00111110
01111110
11111110
00000000
