11110000
10010000
10010000
11110000
10010000
10010000
11110000
00000000