01000010
00100001
00010000
00001000
00000100
00000010
00000001
00000010
