11111111
10000001
10100101
10000001
10000001
10000001
10000001
01111110
