00111111
01000001
11111111
10000000
10111110
10000000
11111110
00000000