11000011
01111110
00011000
00011000
11111111
10110101
11000011
00000000