01100110
01111000
00011000
11111111
11111111
00010000
00111000
01111100