00000000
00111000
01000100
01000100
01111100
01000100
01000100
01111100
