00010000
00110000
01100000
11000000
11111111
01100000
01100000
00110000
