11111111
10000001
10000001
11111111
00000000
01001010
00111100
11111111