00011100
00111110
01111111
11111111
11101110
11111111
01111110
00111100
