01010101
01111110
11111111
01111110
11111111
01010010
11001010
01000110
