00000000
00111100
01000010
01000010
01010101
01111111
01010101
00000000
