00000000
00000000
00110000
01111000
01111000
00110000
00000000
00000000
