11111111
11000011
10111101
10000001
10111101
11000011
11111111
