00111100
01100110
01100110
00011000
00011000
00011000
00111100
01111110
