01111110
01000010
11100111
10100101
11111111
01000010
11111111
00111100
