00000000
00100010
01110111
01110111
01110111
01110111
00111110
00000000
