01111110
11011111
11111111
01111111
01111111
01111111
01111111
00000000