00111000
01111110
01111110
00111100
00111100
01111110
01111110
00111100