00011000
00111100
01111110
00111100
00011000
01101100
00101100
00011000
