00011000
00111100
01111110
11111111
00011000
00011000
01111110
00111100
