01001000
00100100
01111110
01001010
01001000
01001000
01001000
01001000