01010101
01010101
00111000
01111110
11111111
00111100
00111100
00011000
