00000000
00011000
00000000
11111111
01111110
00111100
00000000
00000000
