00000000
01111000
01111000
01111000
01111110
01111110
00010000
00000000
