00011000
00011000
00111100
00011000
01111110
10111101
00100100
01100110