01111110
01000010
01000010
01111110
01011010
01000010
01000010
