00000000
01100110
11111111
11111111
01111110
01111110
01111110
01111110
