00000000
00000000
00111100
01111110
10111111
11111111
00111100
01111110
