00000000
00001110
00010001
00010101
00001110
00001000
00010101
00000000
