00000000
00111100
01100110
11000011
11000011
11000011
11000011
00000000
