00110000
01111000
11111110
01111100
00111000
00110000
00000000
00000000