01000000
00110000
00011000
00001100
00000110
00000110
00001100
00011000
