11111111
10000001
10011001
10000001
10011001
11111111
11111111
00100100