01100110
01100110
00000000
00001000
00001110
00001000
00001000
00001000
