00100000
01110000
11111000
00111100
00011110
00001111
10001111
10001111
