01010100
01111110
11111111
11001100
11111111
00100100
01010101
00011000