10001000
11111000
00101000
01110111
01111111
01111111
01010101
01010101
