00001110
00011111
00111111
01111111
11111100
11110000
11110000
11100000