111000111
111111111
110000001
110000001
111110111
111000111
111000111
000000000
