00010000
00111000
01111100
11111110
11111111
11111111
11111111
00000000