0
10000000
11110000
11111000
10010100
00111110
00111010
01111011
00000000