01010101
01010101
01111111
01111111
01010000
11110001
01010000
11101000