00000000
01111110
10100010
10100010
01111110
00000000
01010101
01111110