00011000
00111100
01111110
00100100
00100100
00011000
00011000
00011000
