01111110
11011011
11000011
11000011
11111111
11111111
01111110
00000000