00000000
00000100
00001100
00011110
00011110
00001100
00011000
00011000
