00000000
00001000
00011100
01111110
00111100
01100110
11000011
00000000