00000000
00100100
01000010
01111110
01000010
00100100
00000000
