01111110
11101111
11000111
10000011
10000011
11111111
01111110
00011000
