11111111
11010111
10110011
10110011
11010111
11111111
00000000
00000000
