00111100
01111110
11111111
11011011
11011011
11011011
01110110
00000000
