00000000
00111100
01111110
11111111
11111111
00011000
00011000
00111100