00011000
00011000
00011000
00000100
00111110
00000100
00000100
00000100
