11111111
10000001
11000011
11100111
01111110
01111110
00111100
00011000
