00000000
00111000
01111110
11111111
11111111
11111111
00111000
00000000
