11111111
10011001
10111101
10111101
01111110
01111110
01100110
01100110