01111100
11111110
11000000
11110000
11011100
01111110
00111110
00000000