01010100
11111111
10101010
00000000
11011011
01100110
00000000
00000000