00010000
00111000
01111100
01111100
01111100
01111100
00111000
00010000
