00000000
01111110
10010001
10101001
10101001
10010001
01111110
00000000