00000000
01111100
01111110
01111110
01111110
01111110
11111110
11111110
