01000010
00100100
00001000
00010000
00100000
01000001
10000010
00000100