01100110
01100110
00000000
11100111
11100111
11111111
11111111
00000000