01100110
11101110
11111111
11011111
01111111
01111110
00111100
00011000