01000010
01100010
00100000
00111000
01111100
00111100
00011100
00001100