01010101
00101000
11111111
11111111
11111111
01111110
00101000
00101000
