01100110
10000001
10100101
10100101
10000001
01111110
00111100
00011000
