01111110
11111111
10011001
10011001
11111111
01111110
00100100
01000010