00000000
00100100
01101110
11111111
11111111
01111110
00111100
00011000
