11111111
10000001
10000001
10100101
11111111
01000010
00111100
00100100