00111100
01000010
10011001
10011001
10011001
10000001
10000001
10000001
