01111100
01000010
01000010
01111100
01001010
01001010
01111100
01000010
