11111111
11000011
10100101
10100101
10100101
10100101
11000011
11111111
