01111110
11000011
10111101
10011001
10011001
10011001
10000001
01111110