00110011
01111011
11111111
11111111
01111100
01111100
00111100
00011000