01111110
11111111
10011001
11000011
11000011
11000011
11000011
11000011