01100110
10011001
10000001
11111111
11111111
10000001
10000001
00000000
