00011100
01111110
11110111
11001110
11001110
11111110
01111110
00111100
