00011000
00111100
01111110
11111111
11111111
11011011
11011011
11111111
