01010101
01010101
00010000
01111110
01010101
10010001
01010101
00000000