00110000
01110000
11110000
11110000
01100000
01100000
01100000
00100000
