00111100
01000010
01000010
11111111
11111111
01111110
01111110
00000000