01100110
10000001
01000010
00111100
00111100
01000010
10000001
01100110