00000000
00000100
00011110
00111110
00110110
01111111
11111111
11111111
