00111100
00111100
01111110
01111110
00100100
01000010
10011001
10000001
