00000000
00001000
00011100
00111110
01111111
11111111
01111111
01111111
