01100110
01000100
11111111
11011011
10000001
10000001
10000001
01111110
