00000000
00000000
00011000
00111100
00111100
01111110
01111110
01111110
