01111000
11001100
00001100
01111110
00001100
00001100
11111111
01111110
