11111111
11000111
10000011
10000011
10000011
10000011
11000111
11111111
