00000000
00111000
00111000
01111110
01111110
01111110
01111110
00000000
