


00011000
00111100
01111110
11111111
01011010
01111110
11111111
11111111
