00011000
00100100
01100110
00100100
00100100
00100100
00100100
00011000
