00000000
00011000
00011000
01111110
00111100
00011000
01111011
00100100
