00011000
00011000
01111110
01111110
00011000
00100100
01000010
10010101