00000000
00100100
01111110
11111111
01111111
00111100
00011000
00000000
