01110000
10001000
10001000
10001000
10001000
10001000
11111000
00000000
