00111100
01100110
11111111
11111111
11111111
00011000
00011000
00000000
