01100110
10100101
11111111
11111111
10111111
01011010
01010101
00011000
