00000000
00111000
01000100
10000010
10000010
10000010
10000010
00000000
