01111110
10000001
10100101
10000001
01111110
00111100
01011010
00011000