01010101
01010101
01111111
01111111
11110001
01010000
111110000
10001000