00000000
00100000
01110000
01111110
01111110
11111111
01111110
00111100
