10001000
11111000
10101000
11110001
01111111
01111111
01010101
01010101