00000000
00010000
00101000
00101000
00101000
01111110
01111110
00101000
