01111000
11111110
01111111
00000000
11111111
11111111
11111111
00000000