00000000
00111100
01111110
11111111
11111111
01111110
00111100
00000000
