00111100
01111110
11111000
11111111
11111111
11111111
00111100
00011000
