00000000
00111100
01111110
01100110
01100110
01111110
01101110
00000000
