00011000
00111100
01111110
11100111
11111111
01111110
00111100
00011000