00000000
01111110
01000010
01000010
01111110
01001010
01000010
00000000
