01111110
00101100
00101100
01111110
11111111
10000001
01010101
00111000