01010101
00111000
01111110
01010101
00111000
01111110
01010101
00111000
