11010110
00101000
01111100
01010100
01111110
00101000
11101110
00101000
