01000100
01111110
01111110
01111110
01111110
01111110
01111110
01010100
