01111110
10000001
10000001
10000001
10000001
10000001
01111110
00000000
