01100110
10010101
10010101
10011001
11111111
10011001
10111011
10000001