0110001001100010
0110001001100010
0000000000000000
1110011110001110
0111111111111110
0111111111111110
0111111111111110
0000000000000000