00110000
01110010
11111111
11111111
01111110
01111110
00110000
00000000