01100110
10011001
10100101
10000001
10111101
01111110
00111100
00010000
