00111100
01111110
11011011
11111111
01111110
00111100
00011000
00011000