01010100
01111110
11111111
01111110
00111100
00101010
01111110
00000000