01010101
01010101
00111100
00101010
00101010
01111110
01000100
00011000
