1100011
1111111
1110111
1110111
1111111
1111111
1111111
0111110