01111100
11111110
11111110
11111110
11111110
11111110
01111100
00111000
