00111100
00111100
00111100
00000000
11111111
01111110
00111100
01100110
