00011000
00111100
01111110
11111111
11111111
10011001
00111100
00011000
