00011000
00111100
01111110
11111111
01100110
01100110
01100110
01111110
