01001000
10011110
01111110
11111111
11111111
01111110
11111111
00111100