00111100
01111110
11111111
11111111
11111111
00100100
00100100
00111100
