01110011
01100011
01010101
01111111
01011001
01011001
01111111
01111111
