00011000
00011000
01111110
00111100
00011000
00111100
00000000
00000000
